######################
######################
##ooooooo##ooooooooo##
##o###o####o####o##o##
##o###o####o####o##o##
##oooooooooooooooooo##
##o###o#o####o##o##o##
##o###o#ooo##o##oooo##
######################
######################